Guy
Simon
Graham
Nico
Ethan 	Olivia 
Jacob 	Emma 
Benjamin 	Abigail 
Joshua 	Elizabeth 
Samuel 	Ava 
William 	Addison 
Isaac 	Brooklyn 
Mason 	Emily 
James 	Sophia 
Andrew 	Madison 
Gavin 	Isabella 
Logan 	Hannah 
Jackson 	Ella 
Luke 	Samantha 
Jack 	Sarah 
Nathan 	Lily 
Michael 	Grace 
Tyler 	Chloe 
David 	Alexis 
Noah 	Kaylee 
Joseph 	Lucy 
Alexander 	Hailey 
Carter 	Savannah 
Daniel 	Anna 
Matthew 	Kate 
Zachary 	Rachel 
Austin 	Avery 
Jaxon 	Claire 
Carson 	Sophie 
Ryan 	Mia 
Gabriel 	Alyssa 
Owen 	Sadie 
Caleb 	Ashley 
Landon 	Taylor 
Anthony 	Natalie 
Dylan 	Gracie 
Cooper 	Megan 
Hunter 	Ellie 
Parker 	Isabelle 
Adam 	Paige 
Thomas 	Amelia 
Aiden 	Sydney 
Jonathan 	Katelyn 
Spencer 	Audrey 
Jayden 	Eliza 
John 	Bailey 
Ian 	Lillian 
Wyatt 	Morgan 
Max 	Lydia 
Kaden 	Brooke 
Braxton 	Kylee 
Christopher 	Ashlyn 
Cole 	Kimberly 
Lincoln 	Kylie 
Porter 	Lauren 
Tanner 	Jessica 
Brayden 	Brianna 
Elijah 	Kaitlyn 
Angel 	Aubrey 
Cameron 	Kayla 
Christian 	Alexa 
Easton 	Maya 
Gage 	Zoe 
Brandon 	Jocelyn 
Hayden 	Ruby 
Ashton 	Vanessa 
Evan 	Aspen 
Jordan 	Evelyn 
Lucas 	Rylee 
Preston 	Makayla 
Jason 	Reagan 
Ryker 	Alexandra 
Diego 	Allison 
Nicholas 	Katie 
Chase 	Halle 
Connor 	Leah 
Kevin 	Lilly 
Aaron 	Andrea 
Boston 	Isabel 
Jose 	Katherine 
Alex 	Mckenna 
Seth 	Kennedy 
Robert 	Sierra 
Aidan 	Brinley 
Henry 	Jasmine 
Kayden 	Clara 
Tyson 	Eva 
Corbin 	Brynlee 
Bridger 	Gabriella 
Jace 	Mary 
Justin 	Sara 
Blake 	Zoey 
Charles 	Faith 
Jared 	Mylee 
Kyler 	Rebecca 
Maxwell 	Sienna 
Luis 	Allie 
Brody 	Bella 
Eli 	Victoria 
Jesse 	Abby 
